SO ./textures/wall_2.xpm
EA ./textures/wall_4.xpm
NO ./textures/wall_1.xpm
WE ./textures/wall_3.xpm

F 220,100,0
C 225,30,0

11111111111111111111111111111
1001000001100000000000111
10000000011100000000000011111
1001000000000000000000011111111111
100111111011000001100000000000001
10000000000100000110111111111111
111101111101100111000000100011
1111011111011001110000100100001
110000001101000111000000000111
10000000000000000000N00010001
1000000000000001111010010001
11011111111111111111111111111
11011                  1011111
11011111111111111111111111111
110000011101010111110111100111
11110111 1110101 101111010001
1111111111111111 11111111111
1111111   11111111 11111111111
