SO ./textures/wall_2.xpm
EA ./textures/wall_4.xpm

WE ./textures/wall_3.xpm

F 220,100,0

C 225,30,0
       NO    ./textures/wall_1.xpm
QF ./textures/boss_walk_front.xpm
QB ./textures/boss_walk_back.xpm
QA ./textures/boss_action.xpm

  11111111111111111111111111111
110000000011000Q0000000111
10010000011100000000000011111
1001000000000D00000000011111111111
110111111011000001100000000000001
1000000Q00010000011D111111111111
111101111101100111000000100011
1111011111011001110000100100001
110000001101000111000000000111
100Q0000000000000D000N0010001
1000000000000001101010010001
11011111111111111111111111111
11011                  1011111
11011111111111111111111111111
110000011101010111110111100111
11110111 1110101 101111010001
1111111111111111 11111111111
1111111   11111111 11111111111
