SO ./textures/wall_2.xpm
WE ./textures/wall_3.xpm
EA ./textures/wall_4.xpm


F 220,100,0
C 225,30,0
       NO    ./textures/wall_1.xpm

   111111111111111111111111111
11100000001100000000000111
10110000011100000000000011111
10010000000000000000000011111111111
111111111011000001110000000000001
100000000011000001110111111111111
11110111111111011100000010001
11110111111111011101010010001
1100000011010101110000010001
10000000000000001100000010001
10000000000000001101010010001
11111111111111111111111111111
11111                  1011111
11111111111111111111111111111
11000001110101011111011110N0111
11110111 1110101 101111010001
1111111111111111 11111111111
1111111   1111111 11111111111
