SO ./textures/wall_2.xpm
EA ./textures/wall_4.xpm

WE ./textures/wall_3.xpm

F 220,100,0

C 225,30,0
       NO    ./textures/wall_1.xpm

   1111111111111111111111111111
11100000001100000000000111
10110000011100000000000011111
1001000000000D00000000011111111111
111111111011000001110000000000001
100000000011000001110111111111111
111101111111110111000000100011
1111011111111101110100100100001
110000001101010111000001000111
10000000000000000D000N0010001
10000000000000001101010010001
11111111111111111111111111111
11111                  1011111
11111111111111111111111111111
110000011101010111110111100111
11110111 1110101 101111010001
1111111111111111 11111111111
1111111   11111111 11111111111
